################################
#                              #
#                              #
#                              #
#                              #
#                              #
#                              #
#                              #
#                              #
#                              #
#                              #
#                              #
#                              #
#                              #
#                              #
#                              #
#        #############         #
#######################      ###