################################
#                              #
#                              #
#                              #
#                              #
#                              #
#                              #
#                              #
#     #                 #      #
#     #    BBBBB        #      #
#     ###################      #
#                              #
#                              #
#                              #
#                              #
#                              #
#                              #
################################