################################
#                              #
#                              #
#                ###           #
#            3      ####       #
#     #                        #
#     ######                ####
#     #2~~                  ####
#     #~~~                     #
#     #~             ####      #
#     #              ####      #
#     ###################      #
#                     ~~#      #
#                     ~5#      #
#                              #
#~~~                           #
#~~~~                          #
################     ###########