################################
#                              #
#                              #
#                              #
#                              #
#                              #
#                              #
#                       ####   #
#     #                 #      #
#     #                 #      #
#     ###################    ###
#                              #
#                              #
#            ####              #
#                              #
#                        ####  #
#                              #
################################